11111111111
1PCE0000001
10001111111
11111111111
11111111111
10000000001
11111111111
11111111111
11111111111
11111111111
11111111111
