11111111
1P0000M1
10000001
1C1C1CE1
10000001
11111111
