1111111111111111111111111
1E10000001M100000000000M1
1M10000001110000003000001
10100C000000C000000000001
1000000000000000000000001
120000000C000030000000001
10000000000000000000000P1
1111111111111111111111111
