11111111111111111
1P223332233C32321
13333223322323231
12323232323333221
13332332323232331
12223322332233221
132323232323233E1
11111111111111111
