1111111111
11P0000011
1110000001
1100000E11
1111111111
