11111111
100C0001
1C000P01
11111111
