1111111111
1P000E0C01
1000000111
1000102301
1111111111
