1111111111
1P300E0C01
1200000111
1000102301
1111111111
