11111111
100C0001
1E000001
100E00P1
11111111
