11111111
100C0001
10000001
1P0E00P1
11111111
