1111111
10010E1
110C001
1001011
1P01001
1111111
