11111111111
10000000001
100P0010011
11100000C11
11E00000011
1111C000011
11111111111
