11111111
10CE0001
1P000101
11111111
